00000000000
01111111110
03313331210
01313131210
01333133310
01111111310
01213333310
01213111110
01223333330
01111111110
00000000000
