00000000000
01111111110
00010001010
01010101010
01000100010
01111111010
01010000010
01010111110
01000000000
01111111110
00000000000
