0000000000000
0111111111110
0331222221210
0131212121210
0132212121210
0131112111210
0131212222210
0131211111110
0131223331210
0131113131210
0133333133330
0111111111110
0000000000000
