0000000000000
0111111111110
0001000001010
0101010101010
0100010101010
0101110111010
0101010000010
0101011111110
0101000001010
0101110101010
0100000100000
0111111111110
0000000000000
